"filename", "language", "Markdown", "C++", "CMake", "comment", "blank", "total"
"/home/alberic/Documents/Cours/MARIO/ramio_project/CMakeLists.txt", "CMake", 0, 0, 8, 0, 6, 14
"/home/alberic/Documents/Cours/MARIO/ramio_project/README.md", "Markdown", 1, 0, 0, 0, 0, 1
"/home/alberic/Documents/Cours/MARIO/ramio_project/external/SFML-install/include/SFML/Audio.hpp", "C++", 0, 17, 0, 33, 7, 57
"/home/alberic/Documents/Cours/MARIO/ramio_project/external/SFML-install/include/SFML/Audio/AlResource.hpp", "C++", 0, 13, 0, 47, 11, 71
"/home/alberic/Documents/Cours/MARIO/ramio_project/external/SFML-install/include/SFML/Audio/Export.hpp", "C++", 0, 9, 0, 29, 11, 49
"/home/alberic/Documents/Cours/MARIO/ramio_project/external/SFML-install/include/SFML/Audio/InputSoundFile.hpp", "C++", 0, 40, 0, 196, 28, 264
"/home/alberic/Documents/Cours/MARIO/ramio_project/external/SFML-install/include/SFML/Audio/Listener.hpp", "C++", 0, 23, 0, 191, 21, 235
"/home/alberic/Documents/Cours/MARIO/ramio_project/external/SFML-install/include/SFML/Audio/Music.hpp", "C++", 0, 53, 0, 251, 34, 338
"/home/alberic/Documents/Cours/MARIO/ramio_project/external/SFML-install/include/SFML/Audio/OutputSoundFile.hpp", "C++", 0, 21, 0, 95, 18, 134
"/home/alberic/Documents/Cours/MARIO/ramio_project/external/SFML-install/include/SFML/Audio/Sound.hpp", "C++", 0, 33, 0, 203, 29, 265
"/home/alberic/Documents/Cours/MARIO/ramio_project/external/SFML-install/include/SFML/Audio/SoundBuffer.hpp", "C++", 0, 44, 0, 276, 33, 353
"/home/alberic/Documents/Cours/MARIO/ramio_project/external/SFML-install/include/SFML/Audio/SoundBufferRecorder.hpp", "C++", 0, 23, 0, 105, 17, 145
"/home/alberic/Documents/Cours/MARIO/ramio_project/external/SFML-install/include/SFML/Audio/SoundFileFactory.hpp", "C++", 0, 44, 0, 131, 23, 198
"/home/alberic/Documents/Cours/MARIO/ramio_project/external/SFML-install/include/SFML/Audio/SoundFileFactory.inl", "C++", 0, 48, 0, 38, 15, 101
"/home/alberic/Documents/Cours/MARIO/ramio_project/external/SFML-install/include/SFML/Audio/SoundFileReader.hpp", "C++", 0, 23, 0, 127, 16, 166
"/home/alberic/Documents/Cours/MARIO/ramio_project/external/SFML-install/include/SFML/Audio/SoundFileWriter.hpp", "C++", 0, 15, 0, 98, 13, 126
"/home/alberic/Documents/Cours/MARIO/ramio_project/external/SFML-install/include/SFML/Audio/SoundRecorder.hpp", "C++", 0, 44, 0, 333, 32, 409
"/home/alberic/Documents/Cours/MARIO/ramio_project/external/SFML-install/include/SFML/Audio/SoundSource.hpp", "C++", 0, 42, 0, 257, 34, 333
"/home/alberic/Documents/Cours/MARIO/ramio_project/external/SFML-install/include/SFML/Audio/SoundStream.hpp", "C++", 0, 63, 0, 307, 36, 406
"/home/alberic/Documents/Cours/MARIO/ramio_project/external/SFML-install/include/SFML/Config.hpp", "C++", 0, 84, 0, 82, 71, 237
"/home/alberic/Documents/Cours/MARIO/ramio_project/external/SFML-install/include/SFML/GpuPreference.hpp", "C++", 0, 11, 0, 50, 14, 75
"/home/alberic/Documents/Cours/MARIO/ramio_project/external/SFML-install/include/SFML/Graphics.hpp", "C++", 0, 30, 0, 32, 7, 69
"/home/alberic/Documents/Cours/MARIO/ramio_project/external/SFML-install/include/SFML/Graphics/BlendMode.hpp", "C++", 0, 46, 0, 151, 19, 216
"/home/alberic/Documents/Cours/MARIO/ramio_project/external/SFML-install/include/SFML/Graphics/CircleShape.hpp", "C++", 0, 21, 0, 116, 18, 155
"/home/alberic/Documents/Cours/MARIO/ramio_project/external/SFML-install/include/SFML/Graphics/Color.hpp", "C++", 0, 36, 0, 216, 24, 276
"/home/alberic/Documents/Cours/MARIO/ramio_project/external/SFML-install/include/SFML/Graphics/ConvexShape.hpp", "C++", 0, 20, 0, 117, 17, 154
"/home/alberic/Documents/Cours/MARIO/ramio_project/external/SFML-install/include/SFML/Graphics/Drawable.hpp", "C++", 0, 17, 0, 95, 15, 127
"/home/alberic/Documents/Cours/MARIO/ramio_project/external/SFML-install/include/SFML/Graphics/Export.hpp", "C++", 0, 9, 0, 29, 11, 49
"/home/alberic/Documents/Cours/MARIO/ramio_project/external/SFML-install/include/SFML/Graphics/Font.hpp", "C++", 0, 72, 0, 329, 39, 440
"/home/alberic/Documents/Cours/MARIO/ramio_project/external/SFML-install/include/SFML/Graphics/Glsl.hpp", "C++", 0, 40, 0, 159, 29, 228
"/home/alberic/Documents/Cours/MARIO/ramio_project/external/SFML-install/include/SFML/Graphics/Glsl.inl", "C++", 0, 52, 0, 90, 14, 156
"/home/alberic/Documents/Cours/MARIO/ramio_project/external/SFML-install/include/SFML/Graphics/Glyph.hpp", "C++", 0, 16, 0, 52, 12, 80
"/home/alberic/Documents/Cours/MARIO/ramio_project/external/SFML-install/include/SFML/Graphics/Image.hpp", "C++", 0, 35, 0, 261, 29, 325
"/home/alberic/Documents/Cours/MARIO/ramio_project/external/SFML-install/include/SFML/Graphics/PrimitiveType.hpp", "C++", 0, 19, 0, 33, 7, 59
"/home/alberic/Documents/Cours/MARIO/ramio_project/external/SFML-install/include/SFML/Graphics/Rect.hpp", "C++", 0, 33, 0, 199, 23, 255
"/home/alberic/Documents/Cours/MARIO/ramio_project/external/SFML-install/include/SFML/Graphics/Rect.inl", "C++", 0, 90, 0, 40, 30, 160
"/home/alberic/Documents/Cours/MARIO/ramio_project/external/SFML-install/include/SFML/Graphics/RectangleShape.hpp", "C++", 0, 19, 0, 97, 17, 133
"/home/alberic/Documents/Cours/MARIO/ramio_project/external/SFML-install/include/SFML/Graphics/RenderStates.hpp", "C++", 0, 27, 0, 129, 19, 175
"/home/alberic/Documents/Cours/MARIO/ramio_project/external/SFML-install/include/SFML/Graphics/RenderTarget.hpp", "C++", 0, 70, 0, 396, 45, 511
"/home/alberic/Documents/Cours/MARIO/ramio_project/external/SFML-install/include/SFML/Graphics/RenderTexture.hpp", "C++", 0, 35, 0, 253, 27, 315
"/home/alberic/Documents/Cours/MARIO/ramio_project/external/SFML-install/include/SFML/Graphics/RenderWindow.hpp", "C++", 0, 25, 0, 240, 20, 285
"/home/alberic/Documents/Cours/MARIO/ramio_project/external/SFML-install/include/SFML/Graphics/Shader.hpp", "C++", 0, 89, 0, 718, 69, 876
"/home/alberic/Documents/Cours/MARIO/ramio_project/external/SFML-install/include/SFML/Graphics/Shape.hpp", "C++", 0, 49, 0, 271, 36, 356
"/home/alberic/Documents/Cours/MARIO/ramio_project/external/SFML-install/include/SFML/Graphics/Sprite.hpp", "C++", 0, 34, 0, 219, 27, 280
"/home/alberic/Documents/Cours/MARIO/ramio_project/external/SFML-install/include/SFML/Graphics/Text.hpp", "C++", 0, 69, 0, 405, 40, 514
"/home/alberic/Documents/Cours/MARIO/ramio_project/external/SFML-install/include/SFML/Graphics/Texture.hpp", "C++", 0, 70, 0, 617, 47, 734
"/home/alberic/Documents/Cours/MARIO/ramio_project/external/SFML-install/include/SFML/Graphics/Transform.hpp", "C++", 0, 40, 0, 405, 35, 480
"/home/alberic/Documents/Cours/MARIO/ramio_project/external/SFML-install/include/SFML/Graphics/Transformable.hpp", "C++", 0, 41, 0, 357, 32, 430
"/home/alberic/Documents/Cours/MARIO/ramio_project/external/SFML-install/include/SFML/Graphics/Vertex.hpp", "C++", 0, 21, 0, 112, 16, 149
"/home/alberic/Documents/Cours/MARIO/ramio_project/external/SFML-install/include/SFML/Graphics/VertexArray.hpp", "C++", 0, 32, 0, 167, 25, 224
"/home/alberic/Documents/Cours/MARIO/ramio_project/external/SFML-install/include/SFML/Graphics/VertexBuffer.hpp", "C++", 0, 49, 0, 324, 36, 409
"/home/alberic/Documents/Cours/MARIO/ramio_project/external/SFML-install/include/SFML/Graphics/View.hpp", "C++", 0, 43, 0, 269, 32, 344
"/home/alberic/Documents/Cours/MARIO/ramio_project/external/SFML-install/include/SFML/Main.hpp", "C++", 0, 7, 0, 28, 9, 44
"/home/alberic/Documents/Cours/MARIO/ramio_project/external/SFML-install/include/SFML/Network.hpp", "C++", 0, 14, 0, 33, 7, 54
"/home/alberic/Documents/Cours/MARIO/ramio_project/external/SFML-install/include/SFML/Network/Export.hpp", "C++", 0, 9, 0, 29, 11, 49
"/home/alberic/Documents/Cours/MARIO/ramio_project/external/SFML-install/include/SFML/Network/Ftp.hpp", "C++", 0, 119, 0, 439, 59, 617
"/home/alberic/Documents/Cours/MARIO/ramio_project/external/SFML-install/include/SFML/Network/Http.hpp", "C++", 0, 101, 0, 333, 49, 483
"/home/alberic/Documents/Cours/MARIO/ramio_project/external/SFML-install/include/SFML/Network/IpAddress.hpp", "C++", 0, 41, 0, 256, 32, 329
"/home/alberic/Documents/Cours/MARIO/ramio_project/external/SFML-install/include/SFML/Network/Packet.hpp", "C++", 0, 71, 0, 401, 61, 533
"/home/alberic/Documents/Cours/MARIO/ramio_project/external/SFML-install/include/SFML/Network/Socket.hpp", "C++", 0, 47, 0, 146, 27, 220
"/home/alberic/Documents/Cours/MARIO/ramio_project/external/SFML-install/include/SFML/Network/SocketHandle.hpp", "C++", 0, 15, 0, 30, 13, 58
"/home/alberic/Documents/Cours/MARIO/ramio_project/external/SFML-install/include/SFML/Network/SocketSelector.hpp", "C++", 0, 25, 0, 216, 23, 264
"/home/alberic/Documents/Cours/MARIO/ramio_project/external/SFML-install/include/SFML/Network/TcpListener.hpp", "C++", 0, 19, 0, 131, 17, 167
"/home/alberic/Documents/Cours/MARIO/ramio_project/external/SFML-install/include/SFML/Network/TcpSocket.hpp", "C++", 0, 37, 0, 253, 27, 317
"/home/alberic/Documents/Cours/MARIO/ramio_project/external/SFML-install/include/SFML/Network/UdpSocket.hpp", "C++", 0, 29, 0, 241, 22, 292
"/home/alberic/Documents/Cours/MARIO/ramio_project/external/SFML-install/include/SFML/OpenGL.hpp", "C++", 0, 27, 0, 32, 20, 79
"/home/alberic/Documents/Cours/MARIO/ramio_project/external/SFML-install/include/SFML/System.hpp", "C++", 0, 21, 0, 34, 6, 61
"/home/alberic/Documents/Cours/MARIO/ramio_project/external/SFML-install/include/SFML/System/Clock.hpp", "C++", 0, 17, 0, 86, 15, 118
"/home/alberic/Documents/Cours/MARIO/ramio_project/external/SFML-install/include/SFML/System/Err.hpp", "C++", 0, 9, 0, 62, 10, 81
"/home/alberic/Documents/Cours/MARIO/ramio_project/external/SFML-install/include/SFML/System/Export.hpp", "C++", 0, 9, 0, 29, 11, 49
"/home/alberic/Documents/Cours/MARIO/ramio_project/external/SFML-install/include/SFML/System/FileInputStream.hpp", "C++", 0, 38, 0, 113, 19, 170
"/home/alberic/Documents/Cours/MARIO/ramio_project/external/SFML-install/include/SFML/System/InputStream.hpp", "C++", 0, 17, 0, 121, 15, 153
"/home/alberic/Documents/Cours/MARIO/ramio_project/external/SFML-install/include/SFML/System/Lock.hpp", "C++", 0, 17, 0, 108, 15, 140
"/home/alberic/Documents/Cours/MARIO/ramio_project/external/SFML-install/include/SFML/System/MemoryInputStream.hpp", "C++", 0, 24, 0, 107, 18, 149
"/home/alberic/Documents/Cours/MARIO/ramio_project/external/SFML-install/include/SFML/System/Mutex.hpp", "C++", 0, 22, 0, 110, 17, 149
"/home/alberic/Documents/Cours/MARIO/ramio_project/external/SFML-install/include/SFML/System/NativeActivity.hpp", "C++", 0, 12, 0, 39, 12, 63
"/home/alberic/Documents/Cours/MARIO/ramio_project/external/SFML-install/include/SFML/System/NonCopyable.hpp", "C++", 0, 16, 0, 99, 15, 130
"/home/alberic/Documents/Cours/MARIO/ramio_project/external/SFML-install/include/SFML/System/Sleep.hpp", "C++", 0, 9, 0, 36, 8, 53
"/home/alberic/Documents/Cours/MARIO/ramio_project/external/SFML-install/include/SFML/System/String.hpp", "C++", 0, 72, 0, 536, 62, 670
"/home/alberic/Documents/Cours/MARIO/ramio_project/external/SFML-install/include/SFML/System/String.inl", "C++", 0, 21, 0, 26, 7, 54
"/home/alberic/Documents/Cours/MARIO/ramio_project/external/SFML-install/include/SFML/System/Thread.hpp", "C++", 0, 34, 0, 227, 22, 283
"/home/alberic/Documents/Cours/MARIO/ramio_project/external/SFML-install/include/SFML/System/Thread.inl", "C++", 0, 49, 0, 30, 12, 91
"/home/alberic/Documents/Cours/MARIO/ramio_project/external/SFML-install/include/SFML/System/ThreadLocal.hpp", "C++", 0, 23, 0, 64, 17, 104
"/home/alberic/Documents/Cours/MARIO/ramio_project/external/SFML-install/include/SFML/System/ThreadLocalPtr.hpp", "C++", 0, 19, 0, 123, 17, 159
"/home/alberic/Documents/Cours/MARIO/ramio_project/external/SFML-install/include/SFML/System/ThreadLocalPtr.inl", "C++", 0, 35, 0, 29, 14, 78
"/home/alberic/Documents/Cours/MARIO/ramio_project/external/SFML-install/include/SFML/System/Time.hpp", "C++", 0, 50, 0, 392, 47, 489
"/home/alberic/Documents/Cours/MARIO/ramio_project/external/SFML-install/include/SFML/System/Utf.hpp", "C++", 0, 118, 0, 588, 58, 764
"/home/alberic/Documents/Cours/MARIO/ramio_project/external/SFML-install/include/SFML/System/Utf.inl", "C++", 0, 482, 0, 129, 142, 753
"/home/alberic/Documents/Cours/MARIO/ramio_project/external/SFML-install/include/SFML/System/Vector2.hpp", "C++", 0, 45, 0, 230, 27, 302
"/home/alberic/Documents/Cours/MARIO/ramio_project/external/SFML-install/include/SFML/System/Vector2.inl", "C++", 0, 87, 0, 38, 37, 162
"/home/alberic/Documents/Cours/MARIO/ramio_project/external/SFML-install/include/SFML/System/Vector3.hpp", "C++", 0, 45, 0, 231, 27, 303
"/home/alberic/Documents/Cours/MARIO/ramio_project/external/SFML-install/include/SFML/System/Vector3.inl", "C++", 0, 94, 0, 38, 37, 169
"/home/alberic/Documents/Cours/MARIO/ramio_project/external/SFML-install/include/SFML/Window.hpp", "C++", 0, 18, 0, 33, 8, 59
"/home/alberic/Documents/Cours/MARIO/ramio_project/external/SFML-install/include/SFML/Window/Clipboard.hpp", "C++", 0, 14, 0, 94, 12, 120
"/home/alberic/Documents/Cours/MARIO/ramio_project/external/SFML-install/include/SFML/Window/Context.hpp", "C++", 0, 30, 0, 144, 22, 196
"/home/alberic/Documents/Cours/MARIO/ramio_project/external/SFML-install/include/SFML/Window/ContextSettings.hpp", "C++", 0, 33, 0, 106, 11, 150
"/home/alberic/Documents/Cours/MARIO/ramio_project/external/SFML-install/include/SFML/Window/Cursor.hpp", "C++", 0, 43, 0, 159, 21, 223
"/home/alberic/Documents/Cours/MARIO/ramio_project/external/SFML-install/include/SFML/Window/Event.hpp", "C++", 0, 127, 0, 132, 26, 285
"/home/alberic/Documents/Cours/MARIO/ramio_project/external/SFML-install/include/SFML/Window/Export.hpp", "C++", 0, 9, 0, 29, 11, 49
"/home/alberic/Documents/Cours/MARIO/ramio_project/external/SFML-install/include/SFML/Window/GlResource.hpp", "C++", 0, 23, 0, 70, 17, 110
"/home/alberic/Documents/Cours/MARIO/ramio_project/external/SFML-install/include/SFML/Window/Joystick.hpp", "C++", 0, 43, 0, 164, 21, 228
"/home/alberic/Documents/Cours/MARIO/ramio_project/external/SFML-install/include/SFML/Window/Keyboard.hpp", "C++", 0, 124, 0, 93, 16, 233
"/home/alberic/Documents/Cours/MARIO/ramio_project/external/SFML-install/include/SFML/Window/Mouse.hpp", "C++", 0, 32, 0, 127, 19, 178
"/home/alberic/Documents/Cours/MARIO/ramio_project/external/SFML-install/include/SFML/Window/Sensor.hpp", "C++", 0, 26, 0, 110, 15, 151
"/home/alberic/Documents/Cours/MARIO/ramio_project/external/SFML-install/include/SFML/Window/Touch.hpp", "C++", 0, 16, 0, 108, 14, 138
"/home/alberic/Documents/Cours/MARIO/ramio_project/external/SFML-install/include/SFML/Window/VideoMode.hpp", "C++", 0, 26, 0, 181, 22, 229
"/home/alberic/Documents/Cours/MARIO/ramio_project/external/SFML-install/include/SFML/Window/Window.hpp", "C++", 0, 68, 0, 506, 49, 623
"/home/alberic/Documents/Cours/MARIO/ramio_project/external/SFML-install/include/SFML/Window/WindowHandle.hpp", "C++", 0, 23, 0, 58, 21, 102
"/home/alberic/Documents/Cours/MARIO/ramio_project/external/SFML-install/include/SFML/Window/WindowStyle.hpp", "C++", 0, 18, 0, 28, 8, 54
"/home/alberic/Documents/Cours/MARIO/ramio_project/external/SFML-install/lib/cmake/SFML/SFMLConfig.cmake", "CMake", 0, 0, 138, 0, 11, 149
"/home/alberic/Documents/Cours/MARIO/ramio_project/external/SFML-install/lib/cmake/SFML/SFMLConfigDependencies.cmake", "CMake", 0, 0, 75, 0, 12, 87
"/home/alberic/Documents/Cours/MARIO/ramio_project/external/SFML-install/lib/cmake/SFML/SFMLConfigVersion.cmake", "CMake", 0, 0, 41, 0, 11, 52
"/home/alberic/Documents/Cours/MARIO/ramio_project/external/SFML-install/lib/cmake/SFML/SFMLSharedTargets-release.cmake", "CMake", 0, 0, 47, 0, 13, 60
"/home/alberic/Documents/Cours/MARIO/ramio_project/external/SFML-install/lib/cmake/SFML/SFMLSharedTargets.cmake", "CMake", 0, 0, 129, 0, 31, 160
"/home/alberic/Documents/Cours/MARIO/ramio_project/external/SFML-install/share/SFML/license.md", "Markdown", 14, 0, 0, 0, 7, 21
"/home/alberic/Documents/Cours/MARIO/ramio_project/external/SFML-install/share/SFML/readme.md", "Markdown", 26, 0, 0, 0, 14, 40
"/home/alberic/Documents/Cours/MARIO/ramio_project/include/Animation.h", "C++", 0, 21, 0, 4, 8, 33
"/home/alberic/Documents/Cours/MARIO/ramio_project/include/Bloc.h", "C++", 0, 44, 0, 4, 13, 61
"/home/alberic/Documents/Cours/MARIO/ramio_project/include/Confetti.h", "C++", 0, 17, 0, 0, 5, 22
"/home/alberic/Documents/Cours/MARIO/ramio_project/include/Entity.h", "C++", 0, 53, 0, 5, 11, 69
"/home/alberic/Documents/Cours/MARIO/ramio_project/include/FinJeu.h", "C++", 0, 23, 0, 0, 8, 31
"/home/alberic/Documents/Cours/MARIO/ramio_project/include/Level.h", "C++", 0, 51, 0, 3, 21, 75
"/home/alberic/Documents/Cours/MARIO/ramio_project/include/Menu.h", "C++", 0, 30, 0, 0, 11, 41
"/home/alberic/Documents/Cours/MARIO/ramio_project/include/Player.h", "C++", 0, 25, 0, 1, 6, 32
"/home/alberic/Documents/Cours/MARIO/ramio_project/src/Animation.cpp", "C++", 0, 23, 0, 4, 7, 34
"/home/alberic/Documents/Cours/MARIO/ramio_project/src/Bloc.cpp", "C++", 0, 57, 0, 6, 16, 79
"/home/alberic/Documents/Cours/MARIO/ramio_project/src/Confetti.cpp", "C++", 0, 23, 0, 0, 7, 30
"/home/alberic/Documents/Cours/MARIO/ramio_project/src/Entity.cpp", "C++", 0, 48, 0, 8, 18, 74
"/home/alberic/Documents/Cours/MARIO/ramio_project/src/FinJeu.cpp", "C++", 0, 41, 0, 8, 10, 59
"/home/alberic/Documents/Cours/MARIO/ramio_project/src/Level.cpp", "C++", 0, 200, 0, 19, 31, 250
"/home/alberic/Documents/Cours/MARIO/ramio_project/src/Menu.cpp", "C++", 0, 123, 0, 0, 19, 142
"/home/alberic/Documents/Cours/MARIO/ramio_project/src/Player.cpp", "C++", 0, 121, 0, 6, 16, 143
"/home/alberic/Documents/Cours/MARIO/ramio_project/src/main.cpp", "C++", 0, 118, 0, 7, 28, 153
"Total", "-", 41, 5536, 438, 18157, 2997, 27169